########################
#!#..#########T######..#
#.#..#......#...##.....#
#....#..##.M..#.#^.....#
###..#......#...##.....#
#....#..#############..#
#..###.................#
#..##################..#
#..#.#p##.....#.#...#..#
#..,.#..#..A..#.#.G.#..#
#.......#.....#.#...#..#
#.M..#..###.###.##.##..#
#......................#
########################