########################
##^##.....#.......##^###
#...#..p../............#
#...#.....#............#
##.####/#############..#
#...............#...#..#
###.####..........A.#..#
#.....##....M...#...#..#
#.#.#.##........#####..#
#..M..##........#...#..#
#.#.#.#####..####.T....#
#..!..##......G.#...#..#
########################